-F------
---D----
-----D--
-----F--
------F-
-D------
-F------
------H-
---D----
-F------
----F---
--F-----
------F-
------D-
----F---
----D---
--H-----
---D----
-----F--
---F----
------D-
-F------
---F----
-----D--
-F------
---F----
--D-----
-----F--